N ./maps/cub1.cub
SO ./maps/cub1.cub 
WE ./maps/cub1.cub
EA ./maps/cub1.cub

F 250,100,0 
C 225,30,0

        1111111111111111111111111
        1000000000110000000000001
        1011000001110000000000001
        1001000000000000000000001
1111111110110000011100000000000001
100000000011000001110111111111111
11110111111111011100000010001
11110111111111011101010010001
11000000110101011100000010001
1000000000000000110000010001
10000000000000001101010010001
110000011101010111110111101N0111
11110111 11101010101111010001
11111111 111111111111111111111