EA ./imgs/start.png
NO ./imgs/wall3.png


WE ./imgs/wall2.png
SO ./imgs/wall1.png

F 100,200,1

C  0,180,255


         1111111111111111111111111
         1000000000110000000000001
         1011000001110000000000001
         1001000000000000000000001
111111111011000001110000000000001
100000000011000001110111111111111
11110111111111011100000010001
11110111111111011101010010001
11010000100000000000000010001
10100100000000000000000000001
10000000000E00000001000000001
10000000000000000000000000001
10000000000000000001111010001
1111111111111111111111111111