NO ./maps/cub1.cub
SO ./maps/cub1.cub
WE ./maps/cub1.cub
EA ./maps/cub1.cub
F 220,100,0
C 225,30,0
         1111111111111111111111111
         1N00000000110000000000001
         1011000001110000000000001
         1001000000000000000000001
111111111011000001110000000000001
100000000011000001110111111111111
11110111111111011100000010001
11110111111111011101010010001
11010000100000000000000010001
10100100000000000000000000001
10000001110000000000000100001
10000000000000000000000000001
10000000000000000001111010001
11111111111111111111111111111