WE ./imgs/wall_W.png


EA ./imgs/wall_E.png
NO ./imgs/wall_N.png

F 100,200,1
SO ./imgs/wall_S.png

C  0,180,255
         1111111111111111111111111
         1000000000110000000000001
         1011000001110000000000001
         1001000000000000000000001
111111111011000001110000000000001
100000000011000001110111111111111
11110000000000000000000010001
11110100000000000001010010001
11010000000000000000000010001
10000000000000000000000000001
100010000000000000001000000001
10000000000000000000000000001
100000000000000000W1111010001
1111111111111111111111111111