N ./maps/cub1.cub
SO ./maps/cub1.cub 
WE ./maps/cub1.cub
EA ./maps/cub1.cub

F 250,100,0 
C 225,30,0

1111111111111111111111111
1100000000000000000000001
1000000000000000000000001
1100001000000000000000001
1000000000000000011100001
1100000000000000111110111
1000100011111101110000001
1000N11111111101110101001
1100000011010101110000001
1000000000000000110000011
1000100011100000110101001
1100000011010101111101111
1111011111110101010111101
1111111111111111111111111