WE ./imgs/wall1.png


EA ./imgs/wall1.png
NO ./imgs/wall2.png

F 100,200,1
SO ./imgs/wall1.png

C  0,180,255


1111111111111111111111111111111111
1        1000000000110000000000001
1        1011000001110000000000001
1    9   1001000000000000000000001
1111111111011000001110000000000001
1000000000011000001110111111111111
11110111111111011100000010001    1
11110111111111011101010010001    1
11010000100000000000000010001    1
10100100000000000000000000001    1
10000000000000W00001000000001    1
10000000000000000000000000001    1
10000000000000000001111010001    1
1111111111111111111111111111111111