N ./maps/cub1.cub
SO ./maps/cub1.cub 
WE ./maps/cub1.cub
EA ./maps/cub1.cub

F 250,100,0 
C 225,30,0

11111111111111
10000000000001
10000001000001
10000010000001
11000100000001
10001000000001
10001000000001
10001000000001
10001000000001
10001000000001
10001000000001
10001000000001
10001000000001
11111111111111
