N ./maps/cub1.cub
SO ./maps/cub1.cub 
WE ./maps/cub1.cub
EA ./maps/cub1.cub

F 250,100,0 
C 225,30,0

 


       	11111111111111111111111111
        1000000000110000000000001
        101100000111000000000000111
        1001000000010000000000001
1111111110110000011100000000000001
110000000011000001111111111111111
11110111111111011100000010001
11110111111111011101010010001
11000000110101011100000010001
1000000000000000110000010001
10000000000000001101010010001
1100000011010101111101110111N
11110111 1110101010111101001
11111111 111111111111111111111