WE ./imgs/wall_N.png
EA ./imgs/wall_S.png
NO ./imgs/wall_W.png
SO ./imgs/wall_E.png

F 220,100,1



C  225,30,0


111111111111111111111111111111111111
101V0G001B0VGD0000001Z00000000000001
10001B101V1D111110G01111111111000001
1G001V1BB01B0V0B1G0G10VV0GAGG0000001
1111111111111111111D10G00GGG00999001
1GBGBGBGBG0S9GGGGGGG10000G00G00G00G1
1GBGBGBG1G009GGGGGGG100G000000B00011
1GBGBG1G011G11111111100000G00V001001
111V1111VV1B111110101000090000900001
1V1V1B0B1VG1V100011110000G0000000001
1V111010DGVD0010111010000000G0000001
1BVVVB101B110010100011111111111111D1
111111111D11111011111009GGVB9GGGBGV1
1VGVBG0V0B0V00GGB0V09009GGVB9GGVVBB1
111111111111111111111111111111111111


A B V D G 9 1