WE ./imgs/wall_N.png
EA ./imgs/wall_S.png
NO ./imgs/wall_W.png
SO ./imgs/wall_E.png

F 220,100,1



C  225,30,0


111111111111111111111111111111111111
1S100B001000000000001Z00000A00000001
10001010101B111110G01111090000000001
10001V10001B0V0B100010VV000GG0010001
1111111111111111111D10G00G0V000V0001
1BBBBBBBBB009090000010000G00G00G00G1
1GGGGGGGGG011V111111100G000000B00011
1BBBBBBB000010V00B10100000G00V001001
11101111101V111110101000090000900001
1V101B0B10G1V100011110000G0000000001
1V1110100B0G1010111010000000G0000001
1BVVVB101G1V0010100011111111111111D1
111111111D11111011111009GGVB9GGGBGV1
1VGVBG0V0B0V00GGB0V09009GGVB9GGVVBB1
111111111111111111111111111111111111


A B V D G 9 1