WE ./imgs/wall_E.png


EA ./imgs/wall_W.png
NO ./imgs/wall_S.png

F 100,200,1
SO ./imgs/wall_N.png


C  0,200,255

11111111111111111111111111111111111111111111111111111111111111111111111111111111111111111111
1000000000000000000000000000000000000000000000000000000000000000000000000000000000000000S001
11111111111111111111111111111111111111111111111111111111111111111111111111111111111111111111
