WE ./imgs/wall_W.png


EA ./imgs/wall_E.png
NO ./imgs/wall_N.png

F 100,200,1
SO ./imgs/wall_S.png


C  225,30,0

11111111111111111111111111111111111111111111111111111111111111111111111111111111111111111111
1000000000000000000000000000000000000000000000000000000000000000000000000000000000000000N001
11111111111111111111111111111111111111111111111111111111111111111111111111111111111111111111
