NO ./maps/cub1.cub
SO ./maps/cub1.cub
WE ./maps/cub1.cub
EA ./maps/cub1.cub
F 220,100,0
C 225,30,0
1111111111111
1001000000001
1000011111001
100011E000001
1111111111111