N ./maps/cub1.cub
SO ./maps/cub1.cub 
WE ./maps/cub1.cub
EA ./maps/cub1.cub

F 250,100,0 
C 225,30,0


111111111111111111111111111111111111111111
1E1000000000000C00000C00000000000111111111
101001010010000010100100000001010111111111
1C1001001010101000100100000001011111111111
1P0000000C00C000000000000000000CC111111111
111111111111111111111011111111111111111111
1C0000000011111111111011111111111111111111
111111111010000000000011111111111111111111
111111111010111111111111111111111111111111
111111111010111111111110000111111111111111
111111111010000000000000110111111111111111
111111111011111111111111110111111111111111
111111100000000000000000000111111111111111
111111111111111111111111111111111111111111
111111111111111111111111111111111111111111
111111111111111111111111111111111111111111
111111111111111111111111111111111111111111
111111111111111111111111111111111111111111
111111111111111111111111111111111111111101
111111111111111111111111111111111111111111